FFNNNNNNNN
NNNNNNNNNN
NNNNNNNNNN
FFFFFFFFFF
NNNNNNNNNN
NNNNNNNNNN
NNNNGNNNNN
NNNNNNNNNN
NNSNNNEEEN
NBEEEEESEE
9 1 U F
8 2 1 9 1
